__######__###
_S_S#S#S#S#S#
#####__######
#S#S#S_S#S#S#
######_######
#S#S#S_S#S#S#
######___####
#S#S#S#S#S#S#
####__#######
#S#S#S#S#S#S#
####__#######